to accept - принять (предложение, предмет)
to accompany - сопровождать
to achieve - добиться
to act - действовать
to add - складывать (прибавлять)
to agree with / to accept - согласиться
to aim (at) - целиться
to allow - позволять / разрешать
to answer / to reply - ответить
to apply / to appeal - обратиться (к кому-либо, куда-либо)
to appreciate - ценить
to argue - спорить
to arrive - прибывать
to ask - спросить
to ask (for) - попросить
to ask the way - спросить как пройти
to assume - предполагать
to assume / to belive / to consider - считать (полагать)
to attend - посетить (собрание, мероприятие)
to be afraid (of) - бояться
to be agree with - быть согласным
to be late - опаздывать
to be wrong - ошибаться (быть ошибочного мнения)
to be against something - быть против
to be quiet - не шуметь / вести себя смирно
to be lost - заблудиться
to be able / can - мочь (быть в состоянии) / уметь
to be over / to come to an end - закончиться
to be surprised (at) - удивиться
to be upset - быть расстроенным, огорченным
to be short of something - испытывать недостаток в чем-либо
to be born - родиться
to be allowed - мочь (иметь разрешение)	may /
to be going to / to be about to - собираться делать что-то
to be worth of - стоить (заслуживать)
to be hungry - хотеть есть
to be thirsty - хотеть пить
to be ill - болеть
to beat (beat / beaten) - бить
to begin (began / begun) / to start - начать
to behave / to act - вести себя
to belong to - принадлежать
to bend (bent / bent) - гнуть
to bite (bit / bitten) - кусать
to blame / to accuse - винить / осуждать
to blink - моргать
to blow (blew / blown) - дуть
to book, to make a reservation - забронировать
to borrow - занять / взять в долг
to break (broke / broken) - ломать
to break down / to get out of order - ломаться
to breathe - дышать
to bring (brought / brought) - принести
to bring up - воспитывать
to bring (brought / brought) - привести (кого-то)
to build (built / built) - строить
to burn (burnt / burnt) - сжечь
to buy (bought / bought) - покупать
to calculate - рассчитывать / вычислять
to call - позвонить
to cancel - отменить
to care / to look after - заботиться
to carry - нести
to catch (caught / caught) - поймать / ловить
to catch up - нагнать / догнать
to celebrate - праздновать
to change one's mind - передумать
to change - изменить (что-то)
to charge - заряжать (телефон)
to check out - выписаться из отеля
to check / to verify / to review - проверять
to chew - жевать
to choose (chose / chosen) - выбирать
to clarify / to make clear - прояснить
to clean - чистить
to close / to shut - закрыть
to collect / to pick - собирать
to come (came / come) - приходить
to come up - подойти (приблизиться)
to compare - сравнивать
to complain - жаловаться
to complicate - усложнять
to confess - признаться
to confuse - смущать
to consider - рассматривать (вопрос, ситуацию)
to consist of - состоять (из)
to convince (of) - убедить
to cook - готовить еду
to cool - охладить
to correct - исправить
to cost (cost / cost) - стоить
to cough - кашлять
to count on somebody - рассчитывать на кого-то
to count - считать (сосчитать)
to cover - покрывать / прикрывать
to create - создавать
to creep / to crawl - ползать
to cross out - зачеркнуть
to cross a street - перейти улицу
to cry - плакать
to cut off - отрезать
to damage - повредить
to dance - танцевать
to deal with / deal (dealt / dealt) - иметь дело с
to deceive - обманывать
to decide / to make a decision - решить (что делать) / принять решение
to declare / to claim / to state - заявлять
to deliver - доставлять
to demand - требовать
to deny - отрицать
to depart - отправиться (в поездку)
to depend (on) - зависеть (от)
to describe - описывать
to destroy - уничтожить
to destroy / to ruin - разрушать
to die - умирать
to differ - отличаться
to discuss / to talk over - обсуждать
to distinguish - различать
to distribute / to spread - распространять
to disturb - беспокоить / побеспокоить
to divide by three - делить на три
to do a favour - сделать одолжение
to doubt - сомневаться
to draw his attention - привлечь его внимание
to draw (drew / drawn) - рисовать
to dream (dreamt / dreamt) - мечтать
to drink (drank / drunk) - пить
to drive (drove / driven) - управлять машиной
to drop - бросить / уронить / бросать
to drop a hint / to hint (at) - намекнуть
to dry - сушить
to eat (ate / eaten) - кушать
to embrace / to hug - обнять
to emerge from / to come out of - появиться (откуда-то)
to emphasize / to accent - сделать ударение
to enjoy - наслаждаться
to ensure - обеспечить (исполнение)
to enter / to come in - входить в помещение
to evaluate / to rate - оценивать
to examine - осматривать
to exist - существовать
to expect - ожидать
to explain - объяснять
to express - выражать
to extend - продлить
to fail - потерпеть неудачу
to fall (fell / fallen) - упасть
to fall asleep - заснуть
to fall in love - влюбиться
to feed (fed / fed) - кормить
to feel (felt / felt) - чувствовать
to feel comfortable / to be comfortable - чувствовать себя комфортно
to feel sick - тошнить
to fight (fought / fought) - драться / воевать
to fill - наполнить
to fill in - заполнить (пропуски)
to find out - выяснить
to find a way out / to come up with a solution - найти выход из положения
to find (found / found) - найти
to finish / to complete - закончить / завершить
to fire - уволить
to fix - фиксировать
to fix / to attach - прикрепить
to fix / to repair - чинить
to flow - течь / литься
to fly (flew / flown) - летать
to fly away - улетать
to fold - складывать / сгибать
to follow - следовать за
to follow - следить (выслеживать)
to forbid (forbade / forbidden) - запрещать
to force smb to / to make smb to - заставлять / принуждать
to forget (forgot / forgotten) - забыть
to forgive (forgave / forgiven) - прощать
to forward - переслать (письмо)
to free / to let go - освободить / отпустить
to frighten / to scare - пугать
to get acquainted with - познакомиться
to get into trouble - попасть в беду
to get used to - привыкнуть к
to get worse - портиться
to get (got / got) - добраться
to get a job - получить работу
to get (got / got) / to become (became / become) - стать
to get stuck - застрять
to get tired - устать
to get wet - промокнуть
to get upset - расстроиться
to get ready - подготовиться
to get up - встать утром
to get / to receive - получить
to get ill - заболеть
to get dirty - испачкаться
to give (gave / given) - давать
to give in - уступать
to give up - сдаться
to go (went / gone) - идти
to go away / to leave / to get away - уходить
to go home - идти домой
to go out / to get out - выходить
to go / to ride / to drive - ехать
to go on / to continue - продолжать / продолжаться
to greet / to welcome - приветствовать
to grow (grew / grown) - расти
to guard / to protect - охранять
to guess - отгадывать / угадывать
to haggle / to bargain - торговаться
to hang (hung / hung) - висеть
to hang (hung / hung) - вешать
to happen / to take place - случаться / происходить
to hate - ненавидеть
to have a look at / to glance at - взглянуть
to have fun - веселиться
to have a rest - отдыхать
to have (had / had) / to have got - иметь
to hear (heard / heard) - слышать
to help - помогать
to hesitate - колебаться (в нерешительности)
to hide (hid / hidden) - прятать / прятаться
to hire - нанять
to hit (hit / hit) / to strike - ударить
to hold (held / held) - держать
to hope - надеяться
to hurry / to be in a hurry - спешить
to hurt (hurt / hurt) - причинить боль
to ignore / to disregard - игнорировать
to imagine - воображать / представлять себе
to improve - улучшать
to incline / to lean - наклоняться
to increase - увеличить
to influence - влиять
to inform - сообщать / информировать
to insist on - настаивать на
to inspire - вдохновлять
to intend / to be going to / to be about to - намереваться
to interrupt / to break - прервать
to introduce - представить кого-то кому-то
to invite - пригласить
to iron - гладить (утюгом)
to join / to get in - присоединиться
to jump / to leap / to hop - прыгать
to keep a promise - сдержать обещание
to keep a secret - хранить тайну
to keep (kept / kept) - содержать
to keep (kept / kept) - хранить
to kiss - целовать
to knock - стучаться
to know (knew / known) - знать
to laugh - смеяться
to lay aside - отложить в сторону
to lead (led / led) - вести (за собой)
to learn / to memorize - выучить
to learn / to study - учить (изучать)
to leave (left/left) - уйти / уехать / покинуть
to leave somebody alone - оставить кого-то в покое
to let smb know - дать знать кому-либо
to let (let / let) / to allow / to permit - разрешать
to let in - впускать
to lie (lay / lain) - лежать
to like - любить (когда нравится что-то)
to limit / to confine - ограничивать
to listen (to) - слушать что-либо, кого-либо
to litter - мусорить
to live - жить
to live next door - жить рядом
to lock the door - запереть дверь
to look forward - ожидать с нетерпением
to look after - следить за (заботиться) / присматривать
to look through - просматривать
to look at - смотреть на
to look for - искать
to look out - выглянуть
to look like smb - походить на кого-л.
to look nice - выглядеть красиво
to loose / to loosen - ослабить (тугое)
to lose (lost / lost) - проиграть
to lose (lost / lost) - потерять
to love / to like - любить
to lower - снижать (громкость / цену)
to maintain / to keep up - поддерживать (состояние / порядок)
to make out - разобрать (слова)
to make sense - иметь смысл
to make sure - убедиться
to make a mistake - ошибиться
to make a deal - заключить сделку
to make (made / made) / to do (did / done) - делать
to make a decision - принять решение
to make an attempt - сделать попытку
to make dirty - испачкать
to make up - накраситься
to manage - управлять / руководить
to manage smth / to cope with - суметь / справиться
to marry - жениться / выйти замуж
to matter - иметь значение
to mean / to imply - подразумевать
to mean (meant / meant) - значить
to meet (met / met)
to mention - упоминать
to miss somebody - скучать (по кому-либо)
to miss - пропускать (занятия)
to mix - мешать / смешивать
to move - двигать / двигаться
to move / to relocate - переезжать (в другое место)
to need / to be in need (of) - нуждаться
to negotiate - вести переговоры
to note / to notice - отметить (в разговоре)
to notice smb - заметить кого-либо
to object (to) - возражать
to offend / to injure - обидеть
to offer - предлагать
to open - открыть
to outrage / to offend - оскорбить
to owe - задолжать / быть задолжным
to pack - упаковать
to paint - красить
to pass - проходить / передавать
to pay attention to - обратить внимание
to pay - платить
to perceive - воспринимать
to perform / to fulfill - выполнять
to perform / to make - совершить
to persuade - уговорить / убедить
to pick up - поднять (подобрать)
to place / to put - поместить
to plant - сажать / посадить (растение)
to play - играть
to point at - указывать (на)
to postpone / to delay - отложить (по времени)
to praise - хвалить
to prefer - предпочитать
to prepare - подготовить
to press - нажимать
to pretend - претендовать / притворяться
to prevent (from) - помешать / предотвращать
to prevent - предотвращать
to print - печатать
to produce - производить
to promise / to make a promise / to give a promise - обещать
to protect - защищать
to provide / to supply - предоставить / снабдить
to pull - тянуть
to punish - наказывать
to push - толкать
to put (put / put) / to lay - класть / положить
to put down - опускать (вниз)
to put up (with) - помириться
to put off - снимать / раздеваться
to put on - надеть
to raise - поднимать
to reach - достигнуть
to read (read / read) - читать
to realize - понять / осознать
to recognize - узнать (знакомого)
to reduce - уменьшить
to reduce / to cut down - сокращать
to reflect - отражать (свет, изображение)
to refuse - отказать, отказаться
to reject - отклонить (просьбу, предложение)
to rely on - полагаться на
to remember - помнить
to remember / to recall - вспоминать / вспомнить
to remind smb of smth - напомнить кому-либо о ком-либо
to remove / to eliminate - устранить
to rent - взять на прокат
to repeat - повторять
to resist - сопротивляться
to respect - уважать
to return / to be back / to come back - возвращаться / вернуться
to rise (rose / risen) / to go up - подниматься
to risk / to take a chance - рискнуть
to run (ran / run) - бежать
to rush - мчаться
to rush up - броситься
to satisfy - удовлетворять
to save - спасать
to save / to keep - сохранить
to say (said / said) - сказать (произнести)
to scratch / to scrape - царапать
to screw up - испортить / запороть
to see (saw / seen) - видеть
to seem - казаться
to sell (sold / sold) - продавать
to send (sent / sent) - послать
to serve - служить
to set free - освободить
to shake (shook / shaken) - трясти
to shake hands - поздороваться за руку
to share - делиться (чем-то)
to shine (shone / shone) - светиться / сиять
to shoot (shot / shot) - стрелять
to shorten - укоротить
to shout at - кричать на
to shout / to cry - кричать
to show - показать
to sign - подписывать
to sing (sang / sung) - петь
to sit down - садиться / сесть
to sit next to smb - сидеть рядом с кем-то
to sleep (slept / slept) - спать
to slide (slid / slid) / to slip - скользить
to smile - улыбаться
to smoke - курить
to sneeze - чихать
to solve / to resolve - решить (проблему)
to speak (spoke / spoken) - говорить
to spell - произнести по буквам
to spend (spent / spent) - проводить (время)
to spend - тратить (деньги)
to spill - пролить
to spread (spread / spread) - распределить
to stand (stood / stood) - стоять
to stay / to remain - остаться
to steal (stole / stolen) - воровать
to stick (stuck / stuck) - втыкать
to stop - останаваливать
to stretch - растягивать
to suffer - страдать
to suffer - терпеть (страдания)
to suit / to fit - подходить (соответствовать)
to sum up - подвести итог
to supply / to provide - снабжать
to support - поддерживать (кого-то)
to suppose / to assume - предполагать
to surprise - удивлять
to surround / to encircle - окружать
to suspect - подозревать
to swallow - глотать
to swap / to exchange - поменяться / обменяться
to sweat / to perspire - потеть
to swim (swam / swum) - плавать
to switch on / to turn on - включить
to switch off / to turn off - выключить
to sympathize with - сочувствовать кому-то
to take (took / taken) - взять / брать
to take out - вынуть / достать из
to take into account / to consider - учесть / принять во внимание
to take part / to participate - принимать участие
to take care of - позаботиться
to take the shortest way - пойти кратчайшей дорогой
to talk - поговорить
to taste - пробовать (на вкус)
to teach (taught / taught) / to train - учить (кого-то)
to tear (tore / torn) / to rip - рвать
to tell (told / told) - рассказывать
to tell a lie - солгать
to tell smb to do smth - велеть кому-то сделать что-то
to thank  - поблагодарить
to think (thought / thought) - думать
to threaten /  a threat - угрожать / угроза
to throw (threw / thrown) - кидать / бросать
to tie - связывать (веревкой)
to tie / to bind - привязать
to touch - трогать
to translate - переводить (на другой язык)
to travel - путешествовать / ездить
to treat - обращаться c кем-то
to treat - лечить
to try / to attempt - пробовать / пытаться
to try on - примерить (одежду)
to turn into - превратить в
to turn over - перевернуть
to turn out - оказаться (выясниться)
to turn - повернуть
to turn the corner - повернуть за угол
to understand (understood / understood) - понимать
to unite - объединиться
to use - использовать
to use - употреблять
to visit / to pay a visit to - посетить (друзей, знакомых)
to wait for - ждать
to wake (woke / woken) - будить
to wake up / to wake (woke / woken) - проснуться
to walk - гулять / ходить
to walk - идти пешком
to want / to wish - хотеть
to warn - предупреждать
to wash - мыть
to wash up - вымыть / помыть
to waste - тратить зря
to watch TV - смотреть телевизор
to water - поливать
to wave - махать (рукой)
to wear (wore / worn) - носить (одежду) / быть одетым
to whisper - шептать
to win (won / won) - выиграть
to wish - желать
to work - работать
to worry / to be anxious - беспокоиться / волноваться
to wound - ранить
to write down - записать
to write (wrote / written) - писать
to yawn - зевать